195 195 195 195 195 195 195 195 195 195 195 195 195 195 195 195 195 195 195 195
195 195 195 195 195 195 195 195 195 195 195 195 195 195 195 195 195 195 195 195
195 195 195 195 195 195 195 195 195 195 195 195 195 195 195 195 195 195 195 195
195 195 195 195 195 195 195 195 195 195 195 195 195 195 195 195 195 195 195 195
195 195 195 195 195 195 195 195 195 195 195 195 195 195 195 195 195 195 195 195
195 195 195 195 195 195 195 195 195 195 195 195 195 195 195 195 195 195 195 195
195 195 195 195 195 195 195 195 195 195 195 195 195 195 195 195 195 195 195 195
195 195 195 195 195 195 195 195 195 195 195 195 195 195 195 195 195 195 195 195
195 195 195 195 195 195 195 195 195 195 195 195 195 195 195 195 195 195 195 195
195 195 195 195 195 195 195 195 195 195 195 195 195 195 195 195 195 195 195 195
195 195 195 195 195 195 195 195 195 195 195 195 195 195 195 195 195 195 195 195
195 195 195 195 195 195 195 195 195 195 195 195 195 195 195 195 195 195 195 195
195 195 195 195 195 195 195 195 195 195 195 195 195 195 195 195 195 195 195 195
195 195 195 195 195 195 195 195 195 195 195 195 195 195 195 195 195 195 195 195
195 195 195 195 195 195 195 195 195 195 195 195 195 195 195 195 195 195 195 195

0 0 0 0 0 0 0 0 0 0 0 0 0 0 0 0 0 0 0 0
0 0 0 0 0 0 0 0 0 0 0 0 0 0 0 0 0 0 0 0
224 0 0 0 0 0 0 0 0 0 0 0 0 0 0 0 0 0 0 0
0 0 0 0 0 0 0 0 0 0 0 0 0 0 0 224 0 0 0 0
0 0 0 0 0 0 0 0 0 0 0 0 0 0 0 0 0 0 0 0
0 0 0 0 0 0 0 0 224 0 0 0 0 0 0 0 0 0 0 0
0 0 0 0 0 0 0 0 0 0 0 0 0 0 0 0 0 0 0 0
0 0 0 0 0 0 0 0 0 0 0 0 0 0 0 0 0 0 0 0
0 0 0 0 0 0 0 0 0 0 0 0 0 0 224 0 0 0 0 0
0 0 0 0 0 0 0 0 0 0 0 256 0 0 0 0 0 0 0 0
0 0 0 0 0 0 0 0 0 0 0 0 0 0 0 0 0 0 224 0
0 0 0 0 224 0 0 0 0 0 0 0 0 0 0 224 0 0 0 0
0 0 0 0 0 0 0 0 0 0 0 0 0 0 0 0 0 0 0 0
0 0 0 0 0 0 0 0 0 0 0 0 0 0 0 0 0 0 0 0
0 0 0 0 224 0 0 0 0 0 0 0 0 0 0 0 0 0 0 0
