163 163 163 163 163 163 163 163 163 163 163 163 163 163 163 163 163 163 163 163
163 163 163 163 163 163 163 163 163 163 163 163 163 163 163 163 163 163 163 163
163 163 163 163 163 163 163 163 163 163 163 163 163 163 163 163 163 163 163 163
163 163 163 163 163 163 163 163 163 163 163 163 163 163 163 163 163 163 163 163
163 163 163 163 163 163 163 163 163 163 163 163 163 163 163 163 163 163 163 163
163 163 163 163 163 163 163 163 163 163 163 163 163 163 163 163 163 163 163 163
163 163 163 163 163 163 163 163 163 163 163 163 163 163 163 163 163 163 163 163
163 163 163 163 163 163 163 163 163 163 163 163 163 163 163 163 163 163 163 163
163 163 163 163 163 163 163 163 163 163 163 163 163 163 163 163 163 163 163 163
163 163 163 163 163 163 163 163 163 163 163 163 163 163 163 163 163 163 163 163
163 163 163 163 163 163 163 163 163 163 163 163 163 163 163 163 163 163 163 163
163 163 163 163 163 163 163 163 163 163 163 163 163 163 163 163 163 163 163 163
163 163 163 163 163 163 163 163 163 163 163 163 163 163 163 163 163 163 163 163
163 163 163 163 163 163 163 163 163 163 163 163 163 163 290 163 163 163 163 163
163 163 163 163 163 163 163 163 163 163 163 163 163 163 163 163 163 163 163 163

0 0 0 0 0 0 0 0 0 0 0 0 0 0 0 0 0 0 0 0
0 0 0 0 0 0 0 0 4 0 0 0 0 0 0 0 0 0 0 0
193 0 0 0 0 0 0 0 0 0 0 0 0 4 0 0 0 0 0 0
0 0 92 93 94 0 0 0 0 0 0 0 0 0 0 193 0 0 0 0
0 0 124 125 126 0 0 0 0 0 0 0 4 0 0 0 0 0 0 0
0 92 62 125 126 0 0 0 193 0 0 0 0 0 92 93 94 0 0 0
0 156 157 157 158 0 0 0 0 0 0 0 0 0 124 125 126 0 0 0
0 0 0 0 0 0 0 0 0 0 0 0 0 0 156 157 158 0 0 0
36 0 0 0 0 0 0 0 0 0 0 0 0 0 193 0 0 0 0 0
0 0 0 0 0 0 0 0 0 0 0 225 0 0 4 0 0 0 0 0
0 0 0 0 0 0 0 0 0 0 0 0 0 0 0 0 0 0 193 0
0 0 0 0 193 0 4 0 0 0 0 0 0 0 0 193 0 0 0 0
0 257 258 258 258 258 258 258 258 258 258 258 258 258 258 258 258 258 258 258
257 230 354 354 354 354 354 354 354 354 354 354 354 354 36 354 354 354 354 354
230 354 354 354 354 354 354 354 354 354 354 354 354 354 354 354 354 354 354 354
